WWWWWWWWWWWWWWWWWWWWWWWWWWWWWWWW
W..............................W
W..............................W
W..............................W
W..............................W
W..............................W
W..............................W
~..............................W
W..............................W
W..............................W
W..............................W
W..............................W
W..............................W
W..............................W
W..............................W
WWWWWWWWWWWWWWWWWWWWWWWWWWWWWWWW