::nongeneric::
WWWWWWWWWWWWWWWWWWWWWWWWWWWWW~WW
~..............................W
W...WWWW.......................W
W...WWWW.......................W
W...WWWW.......................W
W...WWWW.......................W
W........................W.....W
W........................W.WWWWW
W........................W.W...W
W........................W.W.W.W
W........................W.W.W.W
W........................W.W.W.W
W........................W...W.W
W........................WWWWW.W
W..............................~
WWWWW~WWWWWWWWWWWWWWWWWWWWWWWWWW
any=(1, 1)
bg="images/dd/env/Bricks.png"